NO ./Makefile
SO ./Makefile
WE ./Makefile
EA ./Makefile

F 220,100,0
C 225,30,0

1111111111111111111
1000000000000000001
1000000000000000001
1000000000000000001
1000000000000000001
1000000000000000001
1000000000000000001
1000000000000000001
1000000000000000001
1000000000000000001
100N000000000000001
1111111111111111111

