NO ./Makefile
SO ./Makefile
WE ./Makefile
EA ./Makefile

F 220,100,0
C 225,30,0


        111111111111111111111111
        100010000011000000000111
        101100000111000000000011
        10010000000000000W000011
11111111101100000111000000000011
10000000001100000111011111111111
11110111111111011100000010001
11110111111111011101010010001
11000000110101011100000010001
10000000000000001100000000001
10000000000000001101010010001
1100000111010101111101111000111
11110111 1110101 101111010001
11111111 1111111 111111111111