NO ./src/textures/Wall2.xpm
SO ./src/textures/Wall7.xpm
WE ./src/textures/Wall4.xpm
EA ./src/textures/Wall8.xpm

C 0, 0, 100
F 0, 0, 0


        111111111111111111111111111111111111111111111111111111111111111
        10001000001100000000E100000001000100000001111111111111111111111
        101100000111000000000000000001000100010001111111111111111111111
        100100000000000000000000001000010000010001111111111111111111111
11111111101100000111000000000000001000010000000001111111111111111111111
10000000001100000111011111110111111111111111111111111111111111111111111
111101111111110111000000100011
11110111111111011101010010001
11000000110101011100000010001
10000000000000001100000000001
10000000000000001101010010001
1100000111010101111101111000111
11110111 1110101 101111010001
11111111 1111111 111111111111