NO ./src/textures/Wall2.xpm
SO ./src/textures/Wall7.xpm
WE ./src/textures/Wall4.xpm
EA ./src/textures/Wall8.xpm

C 123, 123, 100
F 123, 123, 123


        1111111111111111111111111111111111111111111111111111111111111111111111
        10001000001100000000W1000000000000000000000000000100100010000000000001
        1011000001110000000000000010000010000000010000010100100010000000000001
        1001000000000000000000000010000010000000010000010000001000000000000001
111111111011000001110000000000000000000000000000000000000000001000000000000001
100000000011000001110111111101111000111111111111111111111111111111111111111111
111101111111110111000000100011  100001
11110111111111011101010010001   100001 
11000000110101011100000010001   100001 
10000000000000001100000000001   100001 
10000000000000001101010010001   100001
110000011101010111110111100011  100001 
11110111 1110101 101111010001   100001
1000000111000001 100001111111   100001
10000000000000011100000000001111100011111111111111111111111111111111111111111
11110000000000000000000000000011100000000000000000000000000000000000000000001
11000000000000000000000000000000111111110000000000000000000000000001111111011
11111111111111111000000000011100000000000000000000000000000000000000000000001
11111111111110000000000000000000000000000000000000000000000000000000000000001
11111111111111111111111111111111111111111111111111111111111111111111111111111
